D..#####.....##
##.......#..###
##.#####.#....#
##.#.##..#..###
##....##.#.####
##.#.###.#..###
##.#...####....
##.#.#######.##
##.#######...##
##.......##...#
###...####.....
.....####...###
###.#.......###
###..####.#...#
##.....#####A##