D..#####.....##
##.......#..###
##.#######....#
##.#.#####..###
##....####.####
##.#.#####..##.
##.#...####....
##.#.#######.##
##.#######...#.
##.......##...#
###...####.....
.....####...###
###.#.......###
###..####.#...#
##..###..###A##